{
    "MAIN" : {"matriz" : [
        [2, 2 , 2, 2, 2, 2, 2, 2, 2, 2, 2, 2, 2],
        [2, 1 , 1, 1, 1, 1, 1, 1, 1, 1, 1, 1, 2], 
        [2, 3 , 4, 4, 4, 4, 4, 4, 4, 4, 4, 5, 2], 
        [2, 10, 0, 0, 0, 0, 0, 0, 0, 0, 0, 6, 2], 
        [2, 10, 0, 0, 0, 0, 0, 0, 0, 0, 0, 6, 2],
        [2, 10, 0, 0, 0, 0, 0, 0, 0, 0, 0, 6, 2], 
        [2, 10, 0, 0, 0, 0, 0, 0, 0, 0, 0, 6, 2], 
        [2, 10, 0, 0, 0, 0, 0, 0, 0, 0, 0, 6, 2], 
        [2, 10, 0, 0, 0, 0, 0, 0, 0, 0, 0, 6, 2], 
        [2, 10, 0, 0, 0, 0, 0, 0, 0, 0, 0, 6, 2], 
        [2, 10, 0, 0, 0, 0, 0, 0, 0, 0, 0, 6, 2], 
        [2, 10, 0, 0, 0, 0, 0, 0, 0, 0, 0, 6, 2], 
        [2, 2 , 2, 2, 2, 2, 2, 2, 2, 2, 2, 2, 2]
       ],
       "posicao_inicial" : [6, 6],
       "spritesheet" : "main-room",
       "interagiveis" : {"2 0" : {"destino":"SALA1", "inicio" : [2, 11], "tile_num":9},
                         "4 0" : {"destino":"SALA2", "inicio" : [4, 11], "tile_num":9},
                         "6 0" : {"destino":"SALA3", "inicio" : [6, 11], "tile_num":9},
                         "8 0" : {"destino":"SALA4", "inicio" : [8, 11], "tile_num":9},
                         "10 0": {"destino":"SALA5", "inicio" : [10, 11], "tile_num":9},
                         "4 12": {"destino":"SALA6", "inicio" : [4, 1], "tile_num":9},
                         "8 12": {"destino":"SALA7", "inicio" : [8, 1], "tile_num":9}
                        }
        },

    "SALA1" : {"matriz" : [
        [2, 2 , 2, 2, 2, 2, 2, 2, 2, 2, 2, 2, 2],
        [2, 1 , 1, 1, 1, 1, 1, 1, 1, 1, 1, 1, 2], 
        [2, 3 , 4, 4, 4, 4, 4, 4, 4, 4, 4, 5, 2], 
        [2, 10, 0, 0, 0, 0, 0, 0, 0, 0, 0, 6, 2], 
        [2, 10, 0, 0, 0, 0, 0, 0, 0, 0, 0, 6, 2],
        [2, 10, 0, 0, 0, 0, 0, 0, 0, 0, 0, 6, 2], 
        [2, 10, 0, 0, 0, 0, 0, 0, 0, 0, 0, 6, 2], 
        [2, 10, 0, 0, 0, 0, 0, 0, 0, 0, 0, 6, 2], 
        [2, 10, 0, 0, 0, 0, 0, 0, 0, 0, 0, 6, 2], 
        [2, 10, 0, 0, 0, 0, 0, 0, 0, 0, 0, 6, 2], 
        [2, 10, 0, 0, 0, 0, 0, 0, 0, 0, 0, 6, 2], 
        [2, 10, 0, 0, 0, 0, 0, 0, 0, 0, 0, 6, 2], 
        [2, 2 , 2, 2, 2, 2, 2, 2, 2, 2, 2, 2, 2]
        ],
        "spritesheet" : "chess-room",
        "interagiveis" : {"5 0" : {"destino":"MAIN", "inicio" : [8, 1], "tile_num":9},
                          "5 12" : {"destino":"SALA2", "inicio" : [8, 1], "tile_num":9}
                        }
        },

    "SALA2" : {"matriz" : [
        [3, 3 , 3, 3, 3, 3, 3, 3, 3, 3, 3, 3, 3],
        [3, 1 , 13, 15, 15, 1, 15, 1, 16, 1, 13, 1, 3], 
        [3, 4 , 5, 5, 5, 5, 5, 5, 5, 5, 0, 6, 3], 
        [3, 11, 0, 0, 0, 35, 36, 37, 0, 0, 0, 7, 3], 
        [3, 11, 0, 0, 0, 38, 39, 40, 0, 0, 0, 7, 3],
        [3, 11, 0, 0, 0, 41, 42, 43, 0, 0, 0, 7, 3], 
        [3, 11, 0, 0, 0, 0, 0, 0, 0, 0, 0, 7, 3], 
        [3, 11, 0, 0, 0, 0, 0, 0, 0, 0, 0, 7, 3], 
        [3, 11, 0, 0, 0, 0, 0, 0, 0, 0, 0, 7, 3], 
        [3, 26, 27, 28, 0, 44, 45, 46, 0, 53, 54, 55, 3], 
        [3, 29, 30, 31, 0, 47, 48, 49, 0, 56, 57, 58, 3], 
        [3, 32, 33, 34, 0, 50, 51, 52, 0, 59, 60, 61, 3], 
        [3, 3 , 3, 3, 3, 3, 3, 3, 3, 3, 3, 3, 3]
        ],
        "posicao_inicial" : [2, 10],
        "spritesheet" : "cave-room",
        "interagiveis" :{   "1 10" : {"destino":"MAIN", "inicio" : [8, 1], "tile_num":2},
                            "estatuas" : {"8 2" : {"tipo":"metalico", "pos" : [8, 2], "tile_num":23},
                                          "8 5" : {"tipo":"cristalino", "pos" :[8, 5], "tile_num":24},
                                          "8 8" : {"tipo":"cromatico", "pos" :[8, 8], "tile_num":25}
                                        },
                            "colisoes" : [  [3, 5],
                                            [3, 6],
                                            [3, 7],
                                            [4, 5],
                                            [4, 7],
                                            [5, 5],
                                            [5, 6],
                                            [5, 7],
                                            [9, 1],
                                            [9, 2],
                                            [9, 3],
                                            [9, 5],
                                            [9, 6],
                                            [9, 7],
                                            [9, 9],
                                            [9, 10],
                                            [9, 11],
                                            [10, 3],
                                            [10, 5],
                                            [10, 7],
                                            [10, 9],
                                            [11, 3],
                                            [11, 5],
                                            [11, 7],
                                            [11, 9]
                                    ]
                                        }

        },

    "SALA3" : {"matriz" : [
        [2, 2 , 2 , 2 , 2 , 2 , 2 , 2 , 2 , 2 , 2 , 2 , 2],
        [2, 1 , 1 , 1 , 1 , 1 , 1 , 1 , 1 , 1 , 1 , 1 , 2], 
        [2, 3 , 4 , 4 , 4 , 4 , 4 , 4 , 4 , 4 , 4 , 5 , 2], 
        [2, 10, 0 , 0 , 0 , 0 , 0, 0 , 0 , 0 , 21, 6 , 2], 
        [2, 10, 0 , 0, 0 , 0 , 0 , 0 , 0 , 0, 0 , 6 , 2],
        [2, 10, 0 , 0 , 0 , 0 , 0 , 0 , 0 , 0 , 0 , 6 , 2], 
        [2, 10, 0 , 0 , 0 , 0 , 15, 0 , 0 , 0 , 0 , 6 , 2], 
        [2, 10, 0 , 0 , 0 , 0 , 0 , 0 , 0 , 0 , 0 , 6 , 2], 
        [2, 10, 0 , 0 , 0 , 0 , 0 , 0 , 0 , 0 , 0 , 6 , 2], 
        [2, 10, 20, 0, 0 , 0 , 0 , 0 , 0 , 0, 0 , 6 , 2], 
        [2, 10, 0 , 0 , 0 , 0 , 0, 0 , 0 , 0 , 0 , 6 , 2], 
        [2, 9 , 8 , 8 , 8 , 8 , 8 , 8 , 8 , 8 , 8 , 7 , 2], 
        [2, 2 , 2 , 2 , 2 , 2 , 2 , 2 , 2 , 2 , 2 , 2 , 2]
        ],
        "posicao_inicial" : [6, 11],
        "spritesheet" : "desert-room",
        "interagiveis" : {"pedestais" :{
                          "4 3" : {"pedestal":"GULA", "tile_num":16},
                          "3 6" : {"pedestal":"LUXURIA", "tile_num":16},
                          "4 9" : {"pedestal":"PREGUICA", "tile_num":17},
                          "9 3" : {"pedestal":"AVAREZA", "tile_num":16},
                          "10 6" : {"pedestal":"IRA", "tile_num":17},
                          "9 9" : {"pedestal":"INVEJA", "tile_num":17}
                        },
                          "6 6":{"mesa":"ARMA", "tile_num":15},
                          "6 12" : {"destino":"MAIN", "inicio" : [8, 1], "tile_num":11}
                            }
        },
    "SALA4" : {"matriz" : [
        [2, 2 , 2, 2, 2, 2, 2, 2, 2, 2, 2, 2, 2],
        [2, 1 , 1, 1, 1, 1, 1, 1, 1, 1, 1, 1, 2], 
        [2, 3 , 4, 4, 4, 4, 4, 4, 4, 4, 4, 5, 2], 
        [2, 0, 0, 0, 0, 0, 0, 0, 0, 0, 0, 6, 2], 
        [2, 0, 0, 0, 0, 0, 0, 0, 0, 0, 0, 6, 2],
        [2, 0, 0, 0, 0, 0, 0, 0, 0, 0, 0, 6, 2], 
        [2, 0, 0, 0, 0, 0, 0, 0, 0, 0, 0, 6, 2], 
        [2, 0, 0, 0, 0, 0, 0, 0, 0, 0, 0, 6, 2], 
        [2, 0, 0, 0, 0, 0, 0, 0, 0, 0, 0, 6, 2], 
        [2, 0, 0, 0, 0, 0, 0, 0, 0, 0, 0, 6, 2], 
        [2, 0, 0, 0, 0, 0, 0, 0, 0, 0, 0, 6, 2], 
        [2, 0, 0, 0, 0, 0, 0, 0, 0, 0, 0, 6, 2], 
        [2, 2 , 2, 2, 2, 2, 2, 2, 2, 2, 2, 2, 2]
        ],
        "posicao_inicial" : [5, 1],
        "spritesheet" : "maze-room",
        "interagiveis" : {"5 0" : {"destino":"MAIN", "inicio" : [8, 1], "tile_num":9}
                        }
        },
    "SALA5" : {"matriz" : [
        [2, 2 , 2, 2, 2, 2, 2, 2, 2, 2, 2, 2, 2],
        [2, 1 , 1, 1, 1, 1, 1, 1, 1, 1, 1, 1, 2], 
        [2, 3 , 4, 4, 4, 4, 4, 4, 4, 4, 4, 5, 2], 
        [2, 0, 0, 0, 0, 0, 0, 0, 0, 0, 0, 6, 2], 
        [2, 0, 0, 0, 0, 0, 0, 0, 0, 0, 0, 6, 2],
        [2, 0, 0, 0, 0, 0, 0, 0, 0, 0, 0, 6, 2], 
        [2, 0, 0, 0, 0, 0, 0, 0, 0, 0, 0, 6, 2], 
        [2, 0, 0, 0, 0, 0, 0, 0, 0, 0, 0, 6, 2], 
        [2, 0, 0, 0, 0, 0, 0, 0, 0, 0, 0, 6, 2], 
        [2, 0, 0, 0, 0, 0, 0, 0, 0, 0, 0, 6, 2], 
        [2, 0, 0, 0, 0, 0, 0, 0, 0, 0, 0, 6, 2], 
        [2, 0, 0, 0, 0, 0, 0, 0, 0, 0, 0, 6, 2], 
        [2, 2 , 2, 2, 2, 2, 2, 2, 2, 2, 2, 2, 2]
        ],
        "spritesheet" : "lab-room",
        "interagiveis" : {"5 0" : {"destino":"MAIN", "inicio" : [8, 1], "tile_num":9},
                          "5 12" : {"destino":"SALA6", "inicio" : [8, 1], "tile_num":9}
                        }
        },
    "SALA6" : {"matriz" : [
        [2, 2 , 2, 2, 2, 2, 2, 2, 2, 2, 2, 2, 2],
        [2, 1 , 1, 1, 1, 1, 1, 1, 1, 1, 1, 1, 2], 
        [2, 3 , 4, 4, 4, 4, 4, 4, 4, 4, 4, 5, 2], 
        [2, 0, 0, 0, 0, 0, 0, 0, 0, 0, 0, 6, 2], 
        [2, 0, 0, 0, 0, 0, 0, 0, 0, 0, 0, 6, 2],
        [2, 0, 0, 0, 0, 0, 0, 0, 0, 0, 0, 6, 2], 
        [2, 0, 0, 0, 0, 0, 1, 0, 1, 0, 0, 6, 2], 
        [2, 0, 0, 0, 0, 0, 0, 0, 0, 0, 0, 6, 2], 
        [2, 0, 0, 0, 0, 0, 0, 0, 0, 0, 0, 6, 2], 
        [2, 0, 0, 0, 0, 0, 0, 0, 0, 0, 0, 6, 2], 
        [2, 0, 0, 0, 0, 0, 0, 0, 0, 0, 0, 6, 2], 
        [2, 0, 0, 0, 0, 0, 0, 0, 0, 0, 0, 6, 2], 
        [2, 2 , 2, 2, 2, 2, 2, 2, 2, 2, 2, 2, 2]
        ],
        "posicao_inicial" : [5, 1],
        "spritesheet" : "forest-room",
        "interagiveis" : {"5 0" : {"destino":"MAIN", "inicio" : [8, 1], "tile_num":9},
                          "Flor" : {"pos":[6, 6], "tile_num":12},
                          "Mesa" : {"pos":[6, 8], "tile_num":29}
                        }
        },
    "SALA7" : {"matriz" : [
        [2, 2 , 2 , 2 , 2 , 2 , 2 , 2 , 2 , 2 , 2 , 2 , 2],
        [2, 1 , 12, 1 , 1 , 1 , 12, 1 , 12, 1 , 1 , 1 , 2], 
        [2, 3 , 4 , 16, 13, 4 , 4 , 15, 4 , 4 , 16, 5 , 2], 
        [2, 10, 0 , 0 , 0 , 0 , 0 , 0 , 0 , 0 , 0 , 6 , 2], 
        [2, 10, 0 , 0 , 0 , 0 , 0 , 0 , 0 , 0 , 0 , 6 , 2],
        [2, 10, 0 , 0 , 0 , 0 , 0 , 0 , 0 , 0 , 0 , 6 , 2], 
        [2, 10, 0 , 0 , 0 , 0 , 20, 0 , 0 , 0 , 0 , 6 , 2], 
        [2, 10, 0 , 0 , 0 , 0 , 18, 0 , 0 , 0 , 0 , 6 , 2], 
        [2, 10, 0 , 0 , 0 , 0 , 0 , 0 , 0 , 0 , 0 , 6 , 2], 
        [2, 10, 0 , 0 , 0 , 0 , 0 , 0 , 0 , 0 , 0 , 6 , 2], 
        [2, 10, 0 , 0 , 0 , 0 , 0 , 0 , 0 , 0,  0 , 6 , 2], 
        [2, 9 , 8 , 8 , 8 , 8 , 8 , 8 , 8 , 8 , 8 , 7 , 2], 
        [2, 2 , 2 , 2 , 2 , 2 , 11, 2 , 2 , 2 , 2 , 2 , 2]
        ],
        "posicao_inicial" : [12, 7],
        "spritesheet" : "castle-room",
        "interagiveis" : {"12 6" : {"destino":"MAIN", "inicio" : [8, 1], "tile_num":11},
                          "Mesa" : {"pos":[7, 6],"tile_num":18},
                          "Espada" : {"pos":[6, 6], "tile_num":20}}
        }
}
