{
    "MAIN" : {"matriz" : [
        [2, 2 , 2, 2, 2, 2, 2, 2, 2, 2, 2, 2, 2],
        [2, 1 , 1, 1, 1, 1, 1, 1, 1, 1, 1, 1, 2], 
        [2, 3 , 4, 4, 4, 4, 4, 4, 4, 4, 4, 5, 2], 
        [2, 10, 0, 0, 0, 0, 0, 0, 0, 0, 0, 6, 2], 
        [2, 10, 0, 0, 0, 0, 0, 0, 0, 0, 0, 6, 2],
        [2, 10, 0, 0, 0, 0, 0, 0, 0, 0, 0, 6, 2], 
        [2, 10, 0, 0, 0, 0, 0, 0, 0, 0, 0, 6, 2], 
        [2, 10, 0, 0, 0, 0, 0, 0, 0, 0, 0, 6, 2], 
        [2, 10, 0, 0, 0, 0, 0, 0, 0, 0, 0, 6, 2], 
        [2, 10, 0, 0, 0, 0, 0, 0, 0, 0, 0, 6, 2], 
        [2, 10, 0, 0, 0, 0, 0, 0, 0, 0, 0, 6, 2], 
        [2, 10, 0, 0, 0, 0, 0, 0, 0, 0, 0, 6, 2], 
        [2, 2 , 2, 2, 2, 2, 2, 2, 2, 2, 2, 2, 2]
       ],
       "spritesheet" : "main-room",
       "interagiveis" : {"2 0" : {"destino":"SALA1", "inicio" : [2, 11], "tile_num":9},
                         "4 0" : {"destino":"SALA2", "inicio" : [4, 11], "tile_num":9},
                         "6 0" : {"destino":"SALA3", "inicio" : [6, 11], "tile_num":9},
                         "8 0" : {"destino":"SALA4", "inicio" : [8, 11], "tile_num":9},
                         "10 0": {"destino":"SALA5", "inicio" : [10, 11], "tile_num":9},
                         "4 12": {"destino":"SALA6", "inicio" : [4, 1], "tile_num":9},
                         "8 12": {"destino":"SALA7", "inicio" : [8, 1], "tile_num":9}
                        }
        },

    "SALA1" : {"matriz" : [
        [2, 2 , 2, 2, 2, 2, 2, 2, 2, 2, 2, 2, 2],
        [2, 1 , 1, 1, 1, 1, 1, 1, 1, 1, 1, 1, 2], 
        [2, 3 , 4, 4, 4, 4, 4, 4, 4, 4, 4, 5, 2], 
        [2, 10, 0, 0, 0, 0, 0, 0, 0, 0, 0, 6, 2], 
        [2, 10, 0, 0, 0, 0, 0, 0, 0, 0, 0, 6, 2],
        [2, 10, 0, 0, 0, 0, 0, 0, 0, 0, 0, 6, 2], 
        [2, 10, 0, 0, 0, 0, 0, 0, 0, 0, 0, 6, 2], 
        [2, 10, 0, 0, 0, 0, 0, 0, 0, 0, 0, 6, 2], 
        [2, 10, 0, 0, 0, 0, 0, 0, 0, 0, 0, 6, 2], 
        [2, 10, 0, 0, 0, 0, 0, 0, 0, 0, 0, 6, 2], 
        [2, 10, 0, 0, 0, 0, 0, 0, 0, 0, 0, 6, 2], 
        [2, 10, 0, 0, 0, 0, 0, 0, 0, 0, 0, 6, 2], 
        [2, 2 , 2, 2, 2, 2, 2, 2, 2, 2, 2, 2, 2]
        ],
        "spritesheet" : "chess-room",
        "interagiveis" : {"5 0" : {"destino":"MAIN", "inicio" : [8, 1], "tile_num":9},
                          "5 12" : {"destino":"SALA2", "inicio" : [8, 1], "tile_num":9}
                        }
        },

    "SALA2" : {"matriz" : [
        [2, 2 , 2, 2, 2, 2, 2, 2, 2, 2, 2, 2, 2],
        [2, 1 , 1, 1, 1, 1, 1, 1, 1, 1, 1, 1, 2], 
        [2, 3 , 4, 4, 4, 4, 4, 4, 4, 4, 4, 5, 2], 
        [2, 0, 0, 0, 0, 0, 0, 0, 0, 0, 0, 0, 2], 
        [2, 0, 0, 0, 0, 0, 0, 0, 0, 0, 0, 0, 2],
        [2, 0, 0, 0, 0, 0, 0, 0, 0, 0, 0, 0, 2], 
        [2, 0, 0, 0, 0, 0, 0, 0, 0, 0, 0, 0, 2], 
        [2, 0, 0, 0, 0, 0, 0, 0, 0, 0, 0, 0, 2], 
        [2, 0, 0, 0, 0, 0, 0, 0, 0, 0, 0, 0, 2], 
        [2, 0, 0, 0, 0, 0, 0, 0, 0, 0, 0, 0, 2], 
        [2, 0, 0, 0, 0, 0, 0, 0, 0, 0, 0, 0, 2], 
        [2, 0, 0, 0, 0, 0, 0, 0, 0, 0, 0, 0, 2], 
        [2, 2 , 2, 2, 2, 2, 2, 2, 2, 2, 2, 2, 2]
        ],
        "spritesheet" : "cave-room",
        "interagiveis" : {"5 0" : {"destino":"MAIN", "inicio" : [8, 1], "tile_num":9},
                          "5 12" : {"destino":"SALA3", "inicio" : [8, 1], "tile_num":9}
                        }
        },

    "SALA3" : {"matriz" : [
        [2, 2 , 2, 2, 2, 2, 2, 2, 2, 2, 2, 2, 2],
        [2, 1 , 1, 1, 1, 1, 1, 1, 1, 1, 1, 1, 2], 
        [2, 3 , 4, 4, 4, 4, 4, 4, 4, 4, 4, 5, 2], 
        [2, 0, 0, 0, 0, 0, 0, 0, 0, 0, 0, 6, 2], 
        [2, 0, 0, 0, 0, 0, 0, 0, 0, 0, 0, 6, 2],
        [2, 0, 0, 0, 0, 0, 0, 0, 0, 0, 0, 6, 2], 
        [2, 0, 0, 0, 0, 0, 0, 0, 0, 0, 0, 6, 2], 
        [2, 0, 0, 0, 0, 0, 0, 0, 0, 0, 0, 6, 2], 
        [2, 0, 0, 0, 0, 0, 0, 0, 0, 0, 0, 6, 2], 
        [2, 0, 0, 0, 0, 0, 0, 0, 0, 0, 0, 6, 2], 
        [2, 0, 0, 0, 0, 0, 0, 0, 0, 0, 0, 6, 2], 
        [2, 0, 0, 0, 0, 0, 0, 0, 0, 0, 0, 6, 2], 
        [2, 2 , 2, 2, 2, 2, 2, 2, 2, 2, 2, 2, 2]
        ],
        "spritesheet" : "desert-room",
        "interagiveis" : {"5 0" : {"destino":"MAIN", "inicio" : [8, 1], "tile_num":9},
                          "5 12" : {"destino":"SALA4", "inicio" : [8, 1], "tile_num":9}
                        }
        },
    "SALA4" : {"matriz" : [
        [2, 2 , 2, 2, 2, 2, 2, 2, 2, 2, 2, 2, 2],
        [2, 1 , 1, 1, 1, 1, 1, 1, 1, 1, 1, 1, 2], 
        [2, 3 , 4, 4, 4, 4, 4, 4, 4, 4, 4, 5, 2], 
        [2, 0, 0, 0, 0, 0, 0, 0, 0, 0, 0, 6, 2], 
        [2, 0, 0, 0, 0, 0, 0, 0, 0, 0, 0, 6, 2],
        [2, 0, 0, 0, 0, 0, 0, 0, 0, 0, 0, 6, 2], 
        [2, 0, 0, 0, 0, 0, 0, 0, 0, 0, 0, 6, 2], 
        [2, 0, 0, 0, 0, 0, 0, 0, 0, 0, 0, 6, 2], 
        [2, 0, 0, 0, 0, 0, 0, 0, 0, 0, 0, 6, 2], 
        [2, 0, 0, 0, 0, 0, 0, 0, 0, 0, 0, 6, 2], 
        [2, 0, 0, 0, 0, 0, 0, 0, 0, 0, 0, 6, 2], 
        [2, 0, 0, 0, 0, 0, 0, 0, 0, 0, 0, 6, 2], 
        [2, 2 , 2, 2, 2, 2, 2, 2, 2, 2, 2, 2, 2]
        ],
        "spritesheet" : "maze-room",
        "interagiveis" : {"5 0" : {"destino":"MAIN", "inicio" : [8, 1], "tile_num":9},
                          "5 12" : {"destino":"SALA5", "inicio" : [8, 1], "tile_num":9}
                        }
        },
    "SALA5" : {"matriz" : [
        [2, 2 , 2, 2, 2, 2, 2, 2, 2, 2, 2, 2, 2],
        [2, 1 , 1, 1, 1, 1, 1, 1, 1, 1, 1, 1, 2], 
        [2, 3 , 4, 4, 4, 4, 4, 4, 4, 4, 4, 5, 2], 
        [2, 0, 0, 0, 0, 0, 0, 0, 0, 0, 0, 6, 2], 
        [2, 0, 0, 0, 0, 0, 0, 0, 0, 0, 0, 6, 2],
        [2, 0, 0, 0, 0, 0, 0, 0, 0, 0, 0, 6, 2], 
        [2, 0, 0, 0, 0, 0, 0, 0, 0, 0, 0, 6, 2], 
        [2, 0, 0, 0, 0, 0, 0, 0, 0, 0, 0, 6, 2], 
        [2, 0, 0, 0, 0, 0, 0, 0, 0, 0, 0, 6, 2], 
        [2, 0, 0, 0, 0, 0, 0, 0, 0, 0, 0, 6, 2], 
        [2, 0, 0, 0, 0, 0, 0, 0, 0, 0, 0, 6, 2], 
        [2, 0, 0, 0, 0, 0, 0, 0, 0, 0, 0, 6, 2], 
        [2, 2 , 2, 2, 2, 2, 2, 2, 2, 2, 2, 2, 2]
        ],
        "spritesheet" : "lab-room",
        "interagiveis" : {"5 0" : {"destino":"MAIN", "inicio" : [8, 1], "tile_num":9},
                          "5 12" : {"destino":"SALA6", "inicio" : [8, 1], "tile_num":9}
                        }
        },
    "SALA6" : {"matriz" : [
        [2, 2 , 2, 2, 2, 2, 2, 2, 2, 2, 2, 2, 2],
        [2, 1 , 1, 1, 1, 1, 1, 1, 1, 1, 1, 1, 2], 
        [2, 3 , 4, 4, 4, 4, 4, 4, 4, 4, 4, 5, 2], 
        [2, 0, 0, 0, 0, 0, 0, 0, 0, 0, 0, 6, 2], 
        [2, 0, 0, 0, 0, 0, 0, 0, 0, 0, 0, 6, 2],
        [2, 0, 0, 0, 0, 0, 0, 0, 0, 0, 0, 6, 2], 
        [2, 0, 0, 0, 0, 0, 11, 0, 29, 0, 0, 6, 2], 
        [2, 0, 0, 0, 0, 0, 0, 0, 0, 0, 0, 6, 2], 
        [2, 0, 0, 0, 0, 0, 0, 0, 0, 0, 0, 6, 2], 
        [2, 0, 0, 0, 0, 0, 0, 0, 0, 0, 0, 6, 2], 
        [2, 0, 0, 0, 0, 0, 0, 0, 0, 0, 0, 6, 2], 
        [2, 0, 0, 0, 0, 0, 0, 0, 0, 0, 0, 6, 2], 
        [2, 2 , 2, 2, 2, 2, 2, 2, 2, 2, 2, 2, 2]
        ],
        "spritesheet" : "forest-room",
        "interagiveis" : {"5 0" : {"destino":"MAIN", "inicio" : [8, 1], "tile_num":9},
                          "Flor" : {"pos":[6, 6], "tile_num":12}
                        }
        },
    "SALA7" : {"matriz" : [
        [2, 2 , 2, 2, 2, 2, 2, 2, 2, 2, 2, 2, 2],
        [2, 1 , 1, 1, 1, 1, 1, 1, 1, 1, 1, 1, 2], 
        [2, 3 , 4, 4, 4, 4, 4, 4, 4, 4, 4, 5, 2], 
        [2, 0, 0, 0, 0, 0, 0, 0, 0, 0, 0, 6, 2], 
        [2, 0, 0, 0, 0, 0, 0, 0, 0, 0, 0, 6, 2],
        [2, 0, 0, 0, 0, 0, 0, 0, 0, 0, 0, 6, 2], 
        [2, 0, 0, 0, 0, 0, 0, 0, 0, 0, 0, 6, 2], 
        [2, 0, 0, 0, 0, 0, 0, 0, 0, 0, 0, 6, 2], 
        [2, 0, 0, 0, 0, 0, 0, 0, 0, 0, 0, 6, 2], 
        [2, 0, 0, 0, 0, 0, 0, 0, 0, 0, 0, 6, 2], 
        [2, 0, 0, 0, 0, 0, 0, 0, 0, 0, 0, 6, 2], 
        [2, 0, 0, 0, 0, 0, 0, 0, 0, 0, 0, 6, 2], 
        [2, 2 , 2, 2, 2, 2, 2, 2, 2, 2, 2, 2, 2]
        ],
        "spritesheet" : "castle-room",
        "interagiveis" : {"5 0" : {"destino":"MAIN", "inicio" : [8, 1], "tile_num":9}}
        }
}
