{
    "Main" : {"matriz_mapa" : [
        [2, 2 , 2, 2, 2, 2, 2, 2, 2, 2, 2, 2, 2],
        [2, 1 , 1, 1, 1, 1, 1, 1, 1, 1, 1, 1, 2], 
        [2, 3 , 4, 4, 4, 4, 4, 4, 4, 4, 4, 5, 2], 
        [2, 10, 0, 0, 0, 0, 0, 0, 0, 0, 0, 6, 2], 
        [2, 10, 0, 0, 0, 0, 0, 0, 0, 0, 0, 6, 2],
        [2, 10, 0, 0, 0, 0, 0, 0, 0, 0, 0, 6, 2], 
        [2, 10, 0, 0, 0, 0, 0, 0, 0, 0, 0, 6, 2], 
        [2, 10, 0, 0, 0, 0, 0, 0, 0, 0, 0, 6, 2], 
        [2, 10, 0, 0, 0, 0, 0, 0, 0, 0, 0, 6, 2], 
        [2, 10, 0, 0, 0, 0, 0, 0, 0, 0, 0, 6, 2], 
        [2, 10, 0, 0, 0, 0, 0, 0, 0, 0, 0, 6, 2], 
        [2, 10, 0, 0, 0, 0, 0, 0, 0, 0, 0, 6, 2], 
        [2, 2 , 2, 2, 2, 2, 2, 2, 2, 2, 2, 2, 2]
       ],
       "spritesheet" : "main_room",
       "interagiveis" : [{"cords":[5, 0], "destino":"SALA2", "tile_num":9},
                         {"cords":[5, 12], "destino":"SALA3", "tile_num":9}]
        },

       "matriz_sala1" : [
        [2, 2 , 2, 2, 2, 2, 2, 2, 2, 2, 2, 2, 2],
        [2, 1 , 1, 1, 1, 1, 1, 1, 1, 1, 1, 1, 2], 
        [2, 3 , 4, 4, 4, 4, 4, 4, 4, 4, 4, 5, 2], 
        [2, 10, 0, 0, 0, 0, 0, 0, 0, 0, 0, 6, 2], 
        [2, 10, 0, 0, 0, 0, 0, 0, 0, 0, 0, 6, 2],
        [2, 10, 0, 0, 0, 0, 0, 0, 0, 0, 0, 6, 2], 
        [2, 10, 0, 0, 0, 0, 0, 0, 0, 0, 0, 6, 2], 
        [2, 10, 0, 0, 0, 0, 0, 0, 0, 0, 0, 6, 2], 
        [2, 10, 0, 0, 0, 0, 0, 0, 0, 0, 0, 6, 2], 
        [2, 10, 0, 0, 0, 0, 0, 0, 0, 0, 0, 6, 2], 
        [2, 10, 0, 0, 0, 0, 0, 0, 0, 0, 0, 6, 2], 
        [2, 10, 0, 0, 0, 0, 0, 0, 0, 0, 0, 6, 2], 
        [2, 2 , 2, 2, 2, 2, 2, 2, 2, 2, 2, 2, 2]
    ],

    "matriz_sala2" : [
        [2, 2 , 2, 2, 2, 2, 2, 2, 2, 2, 2, 2, 2],
        [2, 1 , 1, 1, 1, 1, 1, 1, 1, 1, 1, 1, 2], 
        [2, 3 , 4, 4, 4, 4, 4, 4, 4, 4, 4, 5, 2], 
        [2, 10, 0, 0, 0, 0, 0, 0, 0, 0, 0, 6, 2], 
        [2, 10, 0, 0, 0, 0, 0, 0, 0, 0, 0, 6, 2],
        [2, 10, 0, 0, 0, 0, 0, 0, 0, 0, 0, 6, 2], 
        [2, 10, 0, 0, 0, 0, 0, 0, 0, 0, 0, 6, 2], 
        [2, 10, 0, 0, 0, 0, 0, 0, 0, 0, 0, 6, 2], 
        [2, 10, 0, 0, 0, 0, 0, 0, 0, 0, 0, 6, 2], 
        [2, 10, 0, 0, 0, 0, 0, 0, 0, 0, 0, 6, 2], 
        [2, 10, 0, 0, 0, 0, 0, 0, 0, 0, 0, 6, 2], 
        [2, 10, 0, 0, 0, 0, 0, 0, 0, 0, 0, 6, 2], 
        [2, 2 , 2, 2, 2, 2, 2, 2, 2, 2, 2, 2, 2]
    ],

    "matriz_sala3" : [
        [2, 2 , 2, 2, 2, 2, 2, 2, 2, 2, 2, 2, 2],
        [2, 1 , 1, 1, 1, 1, 1, 1, 1, 1, 1, 1, 2], 
        [2, 3 , 4, 4, 4, 4, 4, 4, 4, 4, 4, 5, 2], 
        [2, 10, 0, 0, 0, 0, 0, 0, 0, 0, 0, 6, 2], 
        [2, 10, 0, 0, 0, 0, 0, 0, 0, 0, 0, 6, 2],
        [2, 10, 0, 0, 0, 0, 0, 0, 0, 0, 0, 6, 2], 
        [2, 10, 0, 0, 0, 0, 0, 0, 0, 0, 0, 6, 2], 
        [2, 10, 0, 0, 0, 0, 0, 0, 0, 0, 0, 6, 2], 
        [2, 10, 0, 0, 0, 0, 0, 0, 0, 0, 0, 6, 2], 
        [2, 10, 0, 0, 0, 0, 0, 0, 0, 0, 0, 6, 2], 
        [2, 10, 0, 0, 0, 0, 0, 0, 0, 0, 0, 6, 2], 
        [2, 10, 0, 0, 0, 0, 0, 0, 0, 0, 0, 6, 2], 
        [2, 2 , 2, 2, 2, 2, 2, 2, 2, 2, 2, 2, 2]
       ]
}
